1111111111111111111111111
1P0000000000000C000000001
1000000000000000000000001
100000C000000000000000001
1000000000000000000000001
1000000C00000000000000001
1000000000C000000C0000001
100CC0000C000000000000001
100000000C000000000000001
1000000000000000000CC0001
10000000000000000000000C1
10000000000C0000000000001
1000000000000000000000001
1000000000000000000000001
1000000C00000000000000001
1000000000000000000000001
10000C0000000000C00000001
10000000C0C000000000000C1
100000000000C000000000001
1000000000000000000000001
1000000000000000000000001
1CC00000C00000000C0000001
100000000000000000C000001
10000000000000000000000E1
1111111111111111111111111